********************************
*             *            *****
**     ****** *         K  P****
*A            *         ********
*******  ***  *        **      *
*             *       **       *
*    ******   *     ***        *
*             ****             *
*****    ******                *
*             *    *****       *
* *******   *****              *
*             *        *****   *
*   ***   *****                *
*             * *******        *
*****     *****                *
*     ***           ******     *
*                              *
*  ***         ****            *
*                              *
*     ***        *******       *
*                              *
*  ***                 ***     *
*S                             *
*******  ************  ******  *